*********************
*         *  *E     *
*    *    *  ****** *
*    *    *  ***    *
*    *    *    *  ***
*    *    **** *    *
*    *       * *  * *
**** *    **** **** *
*S * *              *
** * ****************
*  *                *
*  *********** ******
*       *           *
*       *           *
*                   *
*                   *
*                   *
*                   *
*********************
